1111111111111111111111111111111111111111
1200000000000011111111111100000000000001
1000000000000011111111111100000000000001
1000000000000011111111111100000000000001
1000000000000011111111111100000000000001
1000000000000011111111111100000000000001
1000000000000011111111111100000000000001
1000000000000011111111111100000000000001
1000000000000011111111111100000000000001
1000000000000011111111111100000000000001
1000000000000011111111111100000000000001
1000000000000011110000111100000000000001
1000000000000011100000011100000000000001
1000000000000011000000001100000000000001
1000000000000011000000001100000000000001
1000000000000011000000001100000000000001
1000000000000011000000001100000000000001
1000000000000011100000011100000000000001
1000000000000011110000111100000000000001
1000000000000011111111111100000000000001
1000000000000011111111111100000000000001
1000000000000011111111111100000000000001
1000000000000011111111111100000000000001
1000000000000011111111111100000000000001
1000000000000011111111111100000000000001
1000000000000011111111111100000000000001
1000000000000011111111111100000000000001
1000000000000011111111111100000000000331
1000000000000011111111111100000000000331
1111111111111111111111111111111111111111