1111111111111111111111111111111111111111
1200011110000000000001111000000000000111
1000011110000000000001111000000000000111
1000011110000000000001111000000000000111
1000011110000000000001111000000000000111
1111100001111000011110000111100000000001
1111100001111000011110000111100000000001
1111100001111000011110000111100000000001
1111100001111000011110000111100000000001
1000011110000000000001111000011110000111
1000011110000000000001111000011110000111
1000011110000000000001111000011110000111
1000011110000000000001111000011110000111
1000000001111000011110000111100001111001
1000000001111000011110000111100001111001
1000000001111000011110000111100001111001
1000000001111000011110000111100001111001
1000011110000111100001111000000000000001
1000011110000111100001111000000000000001
1000011110000111100001111000000000000001
1000011110000111100001111000000000000001
1111100000000000011110000111100001111111
1111100000000000011110000111100001111111
1111100000000000011110000111100001111111
1111100000000000011110000111100001111111
1000011110000000000001111000000001111331
1000011110000000000001111000000001111331
1000011110000000000001111000000001111331
1000011110000000000001111000000001111331
1111111111111111111111111111111111111111