1111111111111111111111111111111111111111
1200000000000000001100000000000000000001
1000000000000000001100000000000000000001
1000000000000000001100000000000000000001
1000000000000000001100000000000000000001
1000000000000000001100000000000000000001
1000000000000000001100000000000000000001
1000000000000000001100000000000000000001
1000000000000000001100000000000000000001
1000000000000000001100000000000000000001
1000000000000000001100000000000000000001
1000000000000000001100000000000000000001
1000000000000000001100000000000000000001
1000000000000000001100000000000000000001
1000000000000000001100000000000000000001
1000000000000000001100000000000000000001
1000000000000000001100000000000000000001
1000000000000000001100000000000000000001
1000000000000000001100000000000000000001
1000000000000000001100000000000000000001
1000000000000000001100000000000000000001
1000000000000000001100000000000000000001
1000000000000000001100000000000000000001
1000000000000000001100000000000000000001
1000000000000000001100000000000000000001
1000000000000000001100000000000000000001
1000000000000000001100000000000000000001
1000000000000000001100000000000000000331
1000000000000000001100000000000000000331
1111111111111111111111111111111111111111