1111111111111111111111111111111111111111
1200000001100000000110000000011000000001
1000000001100000000110000000011000000001
1000000001100000000110000000011000000001
1000000001100000000110000000011000000001
1000000001100000000110000000011000000001
1000000001100000000110000000011000000001
1000000001100000000110000000011000000001
1000000001100000000110000000011000000001
1111111111111111111111111111111111111111
1111111111111111111111111111111111111111
1000000001100000000110000000011000000001
1000000001100000000110000000011000000001
1000000001100000000110000000011000000001
1000000001100000000110000000011000000001
1000000001100000000110000000011000000001
1000000001100000000110000000011000000001
1000000001100000000110000000011000000001
1000000001100000000110000000011000000001
1111111111111111111111111111111111111111
1111111111111111111111111111111111111111
1000000001100000000110000000011000000001
1000000001100000000110000000011000000001
1000000001100000000110000000011000000001
1000000001100000000110000000011000000001
1000000001100000000110000000011000000001
1000000001100000000110000000011000000001
1000000001100000000110000000011000000331
1000000001100000000110000000011000000331
1111111111111111111111111111111111111111