1111111111111111111111111111111111111111
1200001110001110000000011100000000011101
1000000111000111000000001110000000001111
1000000011100011100000000111000000000111
1000000001110001110000000011100000000011
1000000000111000111000000001110000000001
1100000000011100011100000000111000000001
1110000000001110001110000000011100000001
1111000000000111000111001110001110000001
1011100000000011100011100111000111000001
1001110000011100011100000011100011100001
1000111000001110001110000001110001110001
1000011100000111000111000000111000111001
1000001110000011100011100000011100011101
1000000001110001110000000000001110001111
1000000000111000111000000111000111000111
1000000000011100011100000011100011100011
1000000000001110001110000001110001110001
1000000111000111000111000000111000111331
1000000011100011100011100000011100011131
1000000001110001110001110000001110001111
1000111000111000111000111000000111000111
1000011100011100011100011100000011100011
1000001110001110001110001110000001110001
1000000111000111000111000111000000111001
1100000011100011100011100011100000011101
1110000001110000000000000001110000001111
1111000000111000000000000000111000000111
1011100000011100000000000000011100000011
1111111111111111111111111111111111111111